A	AH
A(2)	EY
AM	AE M
AM(2)	EY EH M
ARE	AA R
ARE(2)	ER
BY	B AY
COULD	K UH D
DO	D UW
DOES	D AH Z
DOES(2)	D IH Z
ENOUGH	IH N AH F
ENOUGH(2)	IY N AH F
HELLO	HH AH L OW
HELLO(2)	HH EH L OW
I	AY
IN	IH N
IT	IH T
JOKE	JH OW K
KNOW	N OW
MATTER	M AE T ER
ME	M IY
MEET	M IY T
NANKAI	N AE NG K AY
NEED	N IY D
NEXT	N EH K S T
NEXT(2)	N EH K S
NICE	N AY S
NICE(2)	N IY S
NOT	N AA T
NOW	N AW
PLEASE	P L IY Z
RELAX	R IH L AE K S
RELAX(2)	R IY L AE K S
RIGHT	R AY T
STUDENT	S T UW D AH N T
TELL	T EH L
THANK	TH AE NG K
THE	DH AH
THE(2)	DH IY
TO	T UW
TO(2)	T IH
TO(3)	T AH
UNIVERSITY	Y UW N AH V ER S AH T IY
WAY	W EY
WHO	HH UW
YOU	Y UW
